Nevertheless = Mesmo assim, contudo, todavia, apesar disso, porém.

will be paramount = será primordial

By far the most common thing = De longe, o coisa mais comum

is another built-in = é outro embutido

You’ll almost always have at least one = Você quase sempre terá pelo menos um

rendered = entregue, apresentada, renderizada

mockup = modelo (HTML)

Content = Conteúdo
Padding = Preenchimento
Border = Borda
Margin = Margem

So, before you start banging your head against the wall trying to figure out why = Então, antes de começar a bater a cabeça na parede, tentando descobrir por que

Needless to say = Desnecessário dizer

snippet = trecho

to the - ao

tweak - puxar

endlessly - indefinidamente

glimpse - vislumbre, visão rápida

chunks - pedaços

entrepreneur - empreendedor

by far = de longe

having kittens = ter um filho (Having kittens means you are getting a little angry / Eu vou ter um filho - ter uma ataque de nervos)

inheritance - herança

if I were you - se eu fosse you

so that = para que

once in a while - de vez em quando

hover: flutuar, pairar, rondar em torno de

even number - número par

odd number - número ímpar

stack - pilha, ordem

stacking order =  ordem de empilhamento

rinse - enxaguar

flip - virar





















